BaiLu=Prefabs/BaiLu
BanMa=Prefabs/BanMa
BaoZi=Prefabs/BaoZi
BeiJiXiong=Prefabs/BeiJiXiong
BianFu=Prefabs/BianFu
BianSeLong=Prefabs/BianSeLong
BiMuYu=Prefabs/BiMuYu
BoSiMao=Prefabs/BoSiMao
CangLu=Prefabs/CangLu
CangYing=Prefabs/CangYing
Chan=Prefabs/Chan
ChangJingLu=Prefabs/ChangJingLu
DanDingHe=Prefabs/DanDingHe
DaXiang=Prefabs/DaXiang
DaYan=Prefabs/DaYan
DuJuan=Prefabs/DuJuan
E=Prefabs/E
EYu=Prefabs/EYu
FeiZhouLingYang=Prefabs/FeiZhouLingYang
FengNiao=Prefabs/FengNiao
GeZi=Prefabs/GeZi
GongJi=Prefabs/GongJi
GuanTuo=Prefabs/GuanTuo
HaiBao=Prefabs/HaiBao
HaiGui=Prefabs/HaiGui
HaiLuo=Prefabs/HaiLuo
HaiOu=Prefabs/HaiOu
HaiTun=Prefabs/HaiTun
HaiXing=Prefabs/HaiXing
HeMa=Prefabs/HeMa
HeTun=Prefabs/HeTun
HuangChong=Prefabs/HuangChong
HuangFeng=Prefabs/HuangFeng
HuanWeiHuHou=Prefabs/HuanWeiHuHou
HuDie=Prefabs/HuDie
HuLiYu=Prefabs/HuLiYu
JianLong=Prefabs/JianLong
JianYu=Prefabs/JianYu
JiaoMa=Prefabs/JiaoMa
JingYu=Prefabs/JingYu
JinYu=Prefabs/JinYu
JuZuiNiao=Prefabs/JuZuiNiao
KongQue=Prefabs/KongQue
Lang=Prefabs/Lang
laohu=Prefabs/laohu
LaoShu=Prefabs/LaoShu
LeiLong=Prefabs/LeiLong
LiYu=Prefabs/LiYu
LuCi=Prefabs/LuCi
LuJiaoChong=Prefabs/LuJiaoChong
Lv=Prefabs/Lv
Ma=Prefabs/Ma
Mao=Prefabs/Mao
MaoTouYing=Prefabs/MaoTouYing
MaYi=Prefabs/MaYi
MeiHuaLu=Prefabs/MeiHuaLu
MianYang=Prefabs/MianYang
MiFeng=Prefabs/MiFeng
MiLu=Prefabs/MiLu
MoGuiYu=Prefabs/MoGuiYu
MuYangQuan=Prefabs/MuYangQuan
PiaoChong=Prefabs/PiaoChong
QingTing=Prefabs/QingTing
QingWa=Prefabs/QingWa
QiuZhu=Prefabs/QiuZhu
ShaoZuiYu=Prefabs/ShaoZuiYu
ShaYu=Prefabs/ShaYu
She=Prefabs/She
ShiZi=Prefabs/ShiZi
ShuDaiXiong=Prefabs/ShuDaiXiong
ShuiMu=Prefabs/ShuiMu
ShuiNiu=Prefabs/ShuiNiu
SongShu=Prefabs/SongShu
TangLang=Prefabs/TangLang
TuZi=Prefabs/TuZi
WenZi=Prefabs/WenZi
WoNiu=Prefabs/WoNiu
WuYa=Prefabs/WuYa
Xia=Prefabs/Xia
XiaoChouYu=Prefabs/XiaoChouYu
XieZi=Prefabs/XieZi
XiNiu=Prefabs/XiNiu
XiongMao=Prefabs/XiongMao
XiQue=Prefabs/XiQue
XiYi=Prefabs/XiYi
XueHu=Prefabs/XueHu
XunMengLong=Prefabs/XunMengLong
YanZi=Prefabs/YanZi
YeNiu=Prefabs/YeNiu
YeYa=Prefabs/YeYa
YeZhu=Prefabs/YeZhu
Ying=Prefabs/Ying
YingHuoChong=Prefabs/YingHuoChong
YingWu=Prefabs/YingWu
YunQue=Prefabs/YunQue
ZhiZhu=Prefabs/ZhiZhu
ZhiZhuXie=Prefabs/ZhiZhuXie
ZhuHuan=Prefabs/ZhuHuan
ZhuoMuNiao=Prefabs/ZhuoMuNiao
ZongXiong=Prefabs/ZongXiong